111111111111
1C..DDDD..C1
1..........1
1..........1
1..........1
1....X.....1
1..........1
1..........1
1..DDDD....1
1..........1
111111111111
