111111111111111111111111144222211111333333333333
111111111111111111111111112,,,2.X.13;;;3;3;;4444
111111111111111111111111112,,,2...13;;;3;3;;4444
111111111111111111111111112,,,D...11D111D1;;4444
111111111111111111111111112,,,2.............1111
1111111111111111111111111122222....111111D111111
111111111111111111111111111.......1111......4444
111111111111111111111111111.......1111T....T4444
111111111111111111111111111.......11111111111111 
111111111111111111111111111.......1....B..111111 
111111111111111111111111111.......D.......111111 
111111111111111111111111111...R...11111D11111111 
111111111111111111111111111.......1111...1111111
111111111111111111111111112244444211144444444441 
111111111111111111111111144444444411144444444441 
111111111111111111111111144444444411144444444441
111111111111111111111111144444444411144444444441
111111111111111111111111144444444411144444444441
111111111111111111111111144444444411144444444441
111111111111111111111111144444444411144444444441