1111111111111111111111111111
1C.........C..1............1
1D.....X...................1
1D............1............1
1D............1............1
1D............1............1
1111...111.................1
1........1.................1
1........1.................1
1........1.................1
1........1.................1
1111111111111111111111111111